12,7,11,7,5,13,1,5
9,10,6,8,10,6,8,9
4,6,1,6,5,7,6,8
10,11,10,5,9,9,7,5
7,6,6,2,14,9,9,9
9,13,6,2,7,8,9,9
4,6,5,14,9,7,8,9
10,11,10,6,3,8,13,8
