7,6,5,13,1,1,6,11
9,13,3,6,8,9,7,5
4,6,5,7,6,8,9,9
9,7,8,9,13,6,8,9
14,9,7,8,7,1,11,9
7,8,9,7,8,9,7,8
9,13,8,10,5,9,10,5
10,6,6,6,8,10,6,8
