12,7,6,6,6,5,7,5
9,4,6,6,11,9,9,9
4,8,7,6,6,8,14,9
9,13,8,13,1,6,5,9
10,5,13,1,8,12,9,9
12,10,5,10,5,4,8,9
4,5,9,7,8,10,6,2
14,10,3,8,13,6,6,8
