7,6,6,1,5,13,1,5
14,7,6,8,10,6,8,9
7,8,7,5,7,1,11,9
10,5,9,14,9,10,6,8
12,9,9,12,10,5,7,5
9,10,8,4,5,9,9,14
9,7,5,9,9,9,10,5
10,8,10,8,10,3,6,8
